                            
                            
############################
#............##............#
#.####.#####.##.#####.####.#
#*#  #.#   #.##.#   #.#  #*#
#.####.#####.##.#####.####.#
#..........................#
#.####.##.########.##.####.#
#.####.##.########.##.####.#
#......##....##....##......#
######.##### ## #####.######
     #.##### ## #####.#     
     #.##          ##.#     
     #.## ###  ### ##.#     
######.## #X PI  # ##.######
      .   #  BC Y#   .      
######.## ######## ##.######
     #.##          ##.#     
     #.## ######## ##.#     
######.## ######## ##.######
#............##............#
#.####.#####.##.#####.####.#
#.####.#####.##.#####.####.#
#*..##....... O.......##..*#
###.##.##.########.##.##.###
###.##.##.########.##.##.###
#......##....##....##......#
#.##########.##.##########.#
#.##########.##.##########.#
#..........................#
############################
                            
                            