##################################################
#                                                #
#                                                #
#                                                #
#                                                #
#####                                        #####
    #                                        #
#####                                        #####

#####                                        #####
    #                                        #
#####                                        #####
#                                                #
#                                                #
#                                                #
#                                                #
##################################################